{
    "name" : "2",
    "positions": [
    [6,6,6,6,6,6,6,6,6,6],
    [0,6,1,1,1,1,1,1,6,0],
    [0,0,6,1,4,4,1,6,0,0],
    [0,0,0,6,1,1,6,0,0,0],
    [0,0,0,6,1,1,6,0,0,0],
    [0,0,0,6,6,6,6,0,0,0]
    ]
}