{
    "name" : "4",
    "positions": [
    [0,0,6,6,6,6,6,6,0,0],
    [0,0,4,2,2,2,2,4,0,0],
    [0,0,6,1,4,4,1,6,0,0],
    [0,0,0,6,1,1,6,0,0,0],
    [0,0,6,1,3,1,3,6,0,0],
    [0,6,6,6,6,6,6,6,6,0]
    ]
}